account - счет, считать
across [ə’krɒs]s, through - через, по ту сторону
addition - дополнение
adjust - регулировать, приспосабливать
admire [əd’maɪər] восхищаться
advertisement - реклама
affectionate - ласковый
after - после
again - снова
against - против
agree [ə’gri: ] соглашаться
agreement - соглашение
air - воздух, проветривать
apartment - квартира
summer - лето
spring - весна
autumn -осень
mood - дерево
bush - куст
flower - цветок
watermelon - арбуз
cucumber - огурец
tomato - помидор
tweak подправить, настроить
pear - груша
puddle - лужа
mountain - гора
sea - море
ocean - океан
rhombus - ромб
cell - клетка
rough - шероховатый
separate - отдельный
surprised - удивленный
steep - крутой
ordinary - обычный
round - круглый
square - квадратный
triangular - треугольный
frequent - частый
fetus - плод 
raspberry - малина
along [ə’lɔ:ŋ] prep вдоль, по
among [ə’mʌŋ] prep между, среди
amount - количество, означать, составлять
amusement - развлечение
anger - злость
angle - угол, поворачивать
animal - животное
answer - ответ, отвечать
ant - муравей
apparatus - аппарат
appear [ə’pɪər] появляться
apply - ходатайствовать
approval - одобрение
arch - арка, дуга, выгибать;
area - площадь
argument - спор, аргумент
attach прикреплять, присоединять
attack - нападение, нападать
attempt - попытка, пытаться
attention [ə’tenʃən] внимание
attractive - привлекательный
awful [’ɔ:fəl] ужасный
bag - сумка
ball - мяч
bank [bæŋk] берег (реки)
basket - корзина
bathe [beɪð] купаться
be [bi:] (was / were, been) быть
be afraid of smth / smb бояться чего-л. / кого-л.
be fond of smth обожать что-л.
be frightened of smth / smb сильно бояться чего-л. / кого-л.
be going to do smth собираться что-л. сделать
be over закончиться
be surprised удивляться 
be upset расстраиваться
bear - медведь
beauty - красота
bed - кровать
before - перед
beg - умолять
begin- начинать
behavior - поведение
belief - вера
bell - колокольчик
belong [bɪ’lɔ:ŋ] принадлежать
bench [bentʃ] скамейка
berry - ягода
between - между
bird - птица
birth - рождение
bit - частица, бит
bite - кусать
bite - укус, кусать
bitter - горький
blade - лезвие
blanket - одеяло
blood - кровь
blow - удар, дуть
board - доска
boat - лодка, судно
boiling - кипение
bone - кость
bookmark - закладка (в браузере)
bottle - бутылка
bottom - нижний
bow [[baʋ] поклон; v кланяться
braided - плетеный
brain - мозг
brake - тормоз, тормозить
branch - ветвь, отделение
brass - медь, руководство
brave [breɪv] храбрый
breath - дыхание
brick - кирпич
bridge - мост
bright - яркий, умный
broken - сломанный
brush - кисть
bucket - ведро, черпать
building [bɪldɪŋ] здание
bulb - луковица, выпирать
burrow - нора
burst - взрыв, взрывать
bus - шина
business - бизнес, деловой
butterfly - бабочка
cable - кабель
cake - пирог
camera - камера
card - карта, чесать
cardigan - джемпер
care - забота, лечение
carriage - вагон
carriage [kærɪdʒ] карета
cart - везти
castle [kɑːsl] замок
cat - кот
catch [kætʃ] (caught, caught) ловить, поймать, хватать
cause - причина, вызывать
chain - цепь, сеть
chalk - мел, рисовать мелом
chance - шанс, случайный, рисковать
change into превращаться в
character [’kærɪktər] герой, характер
charge - заряжать
chemical - химикат
chest - грудь, сундук
chicken - курица
chief - главный
children's - детский
chin - подбородок
choice [tʃɔɪs] выбор
clean - чистый, чистить
climb [klaɪm] влезать, карабкаться
clock - часы
cloth - ткань, одежда
coal - уголь
coat - пальто, покрывать
coats - пальто
coin [kɔɪn] монета
collar - воротник, хватать
comb - расчёсывать
come down [kʌm daʋn] спускаться вниз
comfort - комфорт
committee - комитет 
common - общий 
communicate - общаться
companion [kəm’pænjən] товарищ; спутник
comparison - сравнение
complex - комплекс
computer case - корпус системного блока
condition - условие, обуславливать
connection - связь
conscious - сознательный
construction - строительство
cook - повар
cooker - плита
copper - медь
copy - копия
cord - шнур, связывать
cork - пробка
cough - кашель
country - страна
cover - покрытие, покрывать, обложка
cow - корова
crack - первоклассный, взламывать
crawl - ползать
credit - кредит, верить
crime - преступление
crop [krɒp] урожай
cruel [’kru:əl] жестокий
crush - давка, сокрушать
cunning [’kʌnɪŋ] хитрый
cupboard - шкаф
current - текущий, поток
curtain - занавес, штора, занавешивать
curtain [’kɜ:rtən] занавеска
curve - кривая, избегать
cushion - подушка, смягчать
damage - повреждение, повреждать
danger - опасность
database - база данных
daughter - дочь
dead [ded] мертвый
debt - долг
decision - решение
decrypt - расшифровывать
defiantly - дерзко
degree - уровень, градус, степень
degrees - град
demand - требовать
dependent - зависимый
depth - глубина
desire - желание, желать
destruction - разрушение
detail - детализировать, детали
developing — разработка
development - развитие
device - устройство
difficult to imagine — трудно вообразить
digestion - вываривание
dinely - мелко
direction - управление
discovery - открытие
discussion - обсуждение
disease - болезнь
disgust - отвращение
dish [dɪʃ] блюдо
diskette — дискета
distance - дистанция
distribution - распределение
divide [də’vaɪd] делить (на несколько частей)
division - подразделение
doctor - доктор
donkey [’dɒŋkɪ] осел
doubt - сомнение
down - вниз
drain - утечка, истощать
draw [drɔ:] (drew, drawn) тянуть; затягивать
drawbridge [drɔ:‚brɪdʒ] подъемный мост
drawer - ящик
drawing - рисунок
dress - платье
dress up - наряжаться
drip - капать
drive [draɪv] (drove, driven) ехать
driver - водитель
drop - капля, опускать
drown [draʋn] тонуть
dry - сухой
duck - утка
ear - ухо
east - восток
educate - воспитывать
education - образование
elastic - эластичный
elegant [’eləgənt] элегантный, изысканный
end - заканчивать, конец
engine - двигатель
enjoy [ɪn’dʒɔɪ] (smth) получать большое удовольствие (от чего-л.)
enough - достаточно
equal - равный, равняться
error - ошибка
even [’i: vən] даже
event - случай, событие
ever - когда-либо, никогда
exchange - обмен
exchange - обмен, обменивать
existence - существование
expansion - расширение
experience - опыт, испытывать
expert - опытный, эксперт
explanation [‚eksplə’neɪʃən] объяснение, разъяснение
factory - завод
fall - падение, осень
fan - вентилятор охлаждения, кулер
fan - поклонник
far [fa:] далеко
Fast - быстрый
fat [faet] толстый; жирный
favourite ['feivarit] любимый
fear [fia] страх
feather - перо, украшать
fee - плата
feed - кормить
feeling - чувство
field - область, поле, выставлять
find - находить
finish- заканчивать
firewall - брандмауэр, межсетевой экран
firm - твердый
first [feist] первый; adv сначала, прежде всего
fish - рыба
flag - флаг, сигнализировать
flame - пылать, пламя
flour - мука
flower - цветок
fly - муха, лететь
fold - сгиб, сворачивать
foolish ['fu: hj] глупый
foot - нога
force - сила, вынуждать, вызывать
forepaw [fo: po:] передняя лапа
form - форма
forward - отправлять, вперед
fowl - домашняя птица
fragrant - ароматный
frightened ['fraitnd] испуганный
front side — передняя сторона
fry - жарить
full - полный
fur [f3:] мех
fury - ярость
gate [geit] ворота
gateway - шлюз
generation - поколение
gentleman ['cfcentlman] джентльмен
giant ['djaiant] великан
gift - подарок
gift [gift] подарок
give - дать
give birth - рожать
glory - слава
gloves - перчатки
go by [gəʊ bai] v проходить (о времени)
goat - коза
golden - золотой
goose - гусь
grain - зерно
guard [ga: d] стражник
hall [hɔ:l] зал
hammer - молоток
hand - рука
handsome [’hænsəm] красивый (о мужчине)
hanging - вывешивание, висение
harbor - приютить, вставать на якорь, гавань
hard - жесткий
hate - ненавидеть, очень не хотеть, ненависть
hay [heɪ] сено
head - голова
headphones наушники
hearing - слушание, слух
heat - нагревать, высокая температура
heavy - тяжелый
hide [haɪd] (hid, hidden) прятать(ся)
high [haɪ] высокий
hockey-player — хоккеист 
hold [həʋld] (held, held) держать
hole - дыра
homeland - родина
honest [’ɒnɪst] честный
hook - крюк, вербовать
horn - рожок 
hunger [’hʌŋgər] голод
husband [’hʌzbənd] муж
implementation — реализация
impossible [ɪm’pɒsəbəl] невозможный
In-demand - востребованный
Individual – индивидуальный
ink - чернила
interest - интерес, процент, доля
internal - внутренний
invention - изобретение
invite [’ɪnvaɪt] приглашать
iron - железный
island - остров
itself [ɪt’self] pron сам, сама, само
jelly - превращать в желе, желе
jewel - драгоценный камень
Joint - совместный
journey [’dʒɜ:rnɪ] путешествие
joy - радость
juice - сок
just [dʒʌst] как раз; совершенно
keep [ki: p] (kept, kept) держать(ся); сохранять(ся)
kettle - чайник
kitchen - кухня
knife - нож 
knitted - вязаный
knot - узел
land - земля
land [lænd] земля
laptop - ноутбук, портативный компьютер
large - большой
large - крупный
latex - латексный
laugh - смеяться, смех
lead - принуждать, побеждать, вести, лидерство
leadership - руководство
leaf - лист, покрывать листвой
learn- учить
learning - изучение, обучение
leather - кожа
leather - кожаный
Leave - оставить
leave- покидать
legal notes — юридическое заявление
level - уровень, выравнивать, направлять
library - библиотека
lie [laɪ] (lay, lain) лежать
lie down ложиться
LIFO — последним пришёл — первым обслужен
light - освещать, легкий, свет
light-emitting diode (LED) - светодиод
lightweight - легкий
limit - ограничивать
line - линия, очередь, выравнивать
line disciplines — протокол линии
linen - льняной, полотно
lion [’laɪən] лев
lip - губа
liquid - жидкий, жидкость
list - список, перечислять
littleness  — ничтожность, мелочность, незначительность
long - долго, длинный
loop — цикл
lord [b: d] лорд, вельможа
lose - проиграть
loss - потеря
luck [lʌk] удача
machine tool - станок
make a bow поклониться
man - человек
map - карта
mark - марка
marquis [’mɑ:rkwɪs] маркиз
marry [’mærɪ] жениться, выйти замуж
mass - масса
master [’mæstər] хозяин, господин
match - спичка, сделки, соответствовать
maximum - максимальный
meadow [’medəʋ] луг
meanwhile [’mi: n‚waɪl] тем временем
medicine - лекарство
military - военный
mill [mɪl] мельница
miller [’mɪlər] мельник
mind [maɪnd] возражать
mixed - смешанный
mood [mu: d] настроение
moon - луна
motherboard (mainboard) - материнская плата
mountain - гора, горный
move [mu: v] двигаться
movie - фильм
mower [’məʋər] косарь
mowers — косари
muscle |ˈmʌsl| - мускул
mysterious - загадочный
nail - ноготь
narrow [’nærəʋ] узкий
natural blonde. натуральная блондинка
near - рядом, около
neck - шея, обниматься
needle - игла
nerve - нерв
net - чистый, сеть
news - новость
newspaper - газета
node - узел сети
nose - нос
nothing [’nʌƟɪŋ] pron ничего
nylon - капроновый
obtain  - получать
offer [’ɔ:fər] предлагать
on a morning — утром
orange - апельсин, оранжевый
ourself [jəˈselvz] сам, себе, себя
out - вне, снаружи
oven - духовка, печь
packet of biscuits — пачка печенья
pain - боль, причинять боль
paint - краска, рисовать, красить
palace [’pælɪs] дворец
parcel - пакет, распределять
participate - участвовать
partridge [’pɑ:rtrɪdʒ] куропатка
payment - оплата
peace - мир
pencil - карандаш
penny [peni] (pi pennies) пенни, пенс
performance - спектакль
perhaps [pər’hæps] возможно
person - персона
personal - личный
phrase - фраза
pig - свинья
pillow - подушка
pin - булавка, прикреплять
pipe - труба
place - размещать, помещать, занимать место, место
plane - самолёт
plant - завод, растение, прививать, сеять
plastic - пластиковый
plate - тарелка
pleasant - приятный
pleased [pli: zd] довольный
plow - плуг, пахать
pocket [’pɒkɪt]  - карман, присваивать
polish - полировать
polite [pə’laɪt] вежливый
politely [pə’laɪtlɪ] вежливо
pineapple - ананас
private - частный
partial - частичный
pork - свинина
porter - швейцар,носильщик
postman - почтальон
pot - горшок
potato - картофель
potatoes - картофель
power supply unit (PSU) - блок питания
practical [’præktɪkəl] практичный
praying - молиться
pretend [prɪ’tend] притворяться, делать вид
price - цена
pride - гордость
produce - продукт, производить
profession - профессия
profit - прибыль, получать прибыль
proposal - предложение
protection - покровительство
protest - возражать, протест
prove [pru: v] доказывать
public building — общественное здание 
pull [pʋl] тянуть, тащить 
pump - насос, качать
punishment - наказание
pupil - ученик
purchase - покупка
put [pʋt] (put, put) класть, помещать
put on надевать (об одежде)
put out высовывать
quality - качество
query - запрос
quiet - тихий, успокаивать
quietly - тихо
rail - рельс, перевозить поездом
range - диапазон, располагаться
rate - норма,разряд
ray - луч
reaction - реакция
ready - готовый, готов
reaper [’ri: pər] жнец
reason - рассуждать, причина, разум
receipt - квитанция
receive получать, принимать
recognize [’rekəg‚naɪz] узнавать, признавать
record - рекордный, отчёт, делать запись
refrigerator - холодильник
refuse [’refju: s] отказываться
regret - сожаление, сожалеть
regular - регулярный
relatively – относительно
remember [rɪ’membər] помнить
representative - представитель
resistance - стойкость
respect - уважение, уважать
respectively соответственно
responsible - ответственный
rest - отдых, отдыхать, оставаться
reveals показывает
ride [raid] (rode, ridden) скакать
right - верный, право
ring - кольцо, звонить
rod - прут
root - корень
rough - грубый
roughly - грубо
round - вокруг, круглый, раунд
router - маршрутизатор
rub - протирать, тереться
sadness - грусть
sail - парус
same [seɪm] тот же самый
sand - песок
saucepan - кастрюля
scale - измерять, масштаб
scary - страшный
schedule — расписание
school - школа
scissors - ножницы
score - забивать
screw - винт
seam - шов
search engine - поисковая система
seat - сиденье, усаживать, место
secretary - секретарь
seed - семя
selection - выбор
self - сам
selfishness - эгоизм
separate - отдельный, отделять
serious - серьёзный
servant - слуга
servant [’sɜ:rvənt] слуга
several [’sevərəl] несколько, некоторые
shade - оттенок,тень, заштриховывать
shallow - мелкий
sharp - острый
shock - шок, потрясать
shoe - ботинок
shoemaker [’ʃu:‚meɪkər] сапожник
shout [ʃaʋt] кричать
show - предъявлять
sign - знак, признак, подписывать
sign in — войти, зарегистрироваться
signature — подпись
silk - шёлк
silver [’sɪlvər] серебряный
skin - кожа, очищать
slender - стройный
slope - наклон, клониться
smash - удар, разбиваться
smell - запах, пахнуть
smooth - гладкий, мягкий, приглаживать
snail - улитка
sneeze - чиханье, чихать
society - общество
sock - носок
socket - гнездо
socks - носки
sofa - диван
soft - мягкий
software — программное обеспечение
son - сын
soup - суп
sour - кислый
space - пространство, космос
spade - лопата
speech — речь
spiral спираль
spoil - портить
sponge - губка
stadium - стадион
staff — штат
stage - стадия, сцена, организовывать
stale - черствый
stamp - печать, марка, отпечатывать
standing [’stændɪŋ] стоящий
start - начинать
state - состояние
statement — оператор
steam - пар, париться, двигаться
stem - стебель, происходить
step - шаг, шагать
stick - палка, прикреплять
sticky - липкий
stiff - жесткий
still [stil]  - все еще
stitch - стежок, сшивать
stocking - снабжать
stomach - живот, смелость, переваривать
store - магазин, запас
story - история
straight - прямой
stretch - отрезки, протягивать, простираться
string [strɪŋ] завязка, шнурок
strok - гладить
stroller - коляска
strong - сильный
strongly - сильно
structure - структура
student - студент
study - учеба
substance - вещество, сущность
sudden - внезапный
suit [su: t] костюм
surprised [sər’praɪzd] удивленный
switch - коммутатор
tail - хвост, выслеживать
take - взять
take off [teɪk ɒf] v снимать (одежду)
tall grass — высокая трава
tax free — свободный от налогов
teaching - обучение
tendency - тенденция
tender - нежный
terrible - ужасный
terribly [’terəblɪ] ужасно
thank [Ɵæŋk] благодарить
theory - теория
there - там, туда
thermometer - градусник
thick - толстый
thief [Ɵi: f] (pl thieves) вор
thin - тонкий
thing - вещь
this - это, этот
though - хотя
thread - нить, пронизывать
Threaten - угрожать
throat - горло
through [Ɵru:] через, сквозь
thumb - листать, большой палец
thunder - гром, греметь
ticket - билет
tight |taɪt| fitting |ˈfɪtɪŋ| - обтягивающий
till [til] (con) пока, до тех пор пока не
tin - олово,консервная банка
tired - усталый
toe - палец ноги
tooth - зуб
top - возглавлять, вершина, главный
touch - прикосновение, касаться
tower [’taʋər] башня
town - город
trade - торговля, обменивать
train - поезд
tranquility - спокойствие
traveller [’trævələr] путешественник
tray - поднос
treat - лечить
tree - дерево
tremble [’trembəl] дрожать
trick [trɪk] - уловка, обманывать
trouble - проблема, беспокоить
trousers - брюки
turkey - индейка
twist - завихрение, крутить
twist- крутить
university - университет
unusual [ʌn’ju:ʒu:əl] необычный, странный
upper – верхний
upset [ʌp’set] расстроенный, огорченный
upstairs [‚ʌp’steərz] наверх (пo лестнице)
use [ju: z] использовать
useful [’ju: sfəl] полезный
verse - стих
very cheap store — очень дешевый магазин
victory - победа
violent - сильный, жестокий
violet - лиловый
visit [’vɪzɪt] посещать
visitor [’vɪzɪtər] посетитель
waiting - ожидание
warm - теплый, нагревать
wash - мыть
watch - часы
weight - вес, нагружать
wet - мокрый
wheat [wiːt] пшеница
wheel - колесо, вертеть
whip - кнут, хлестать
whistle - свист, свистеть
whole - целый
wide - широкий
wife [[waɪf] жена
win - выиграть
wind - ветер
wine [waɪn] вино
wing - крыло
winter - зима
wire - провод
wireless network - беспроводная сеть
wise - мудрый
wise [waɪz] мудрый
with due attention — с должным вниманием
wood [wud] лес; дерево (материал)
wooden - деревянный
woolen - шерстяной
worry [ˈwʌrɪ] (worried) волноваться, беспокоиться
yard [jɑːd] двор